11111
10011
100C11
1P0E1
11111