1111111111111111111111111111111111
1000000000000000000000000000000001
10000000000000000000000000C0000001
1000000000000000000000000000000001
10000C0000000000000000000000000001
1000000000000000000000000000000001
1000000000000000000000000000000001
1000000002000000000000000000000001
100000000C100000000000000000000001
1000000002000000000000000000000001
100000000000001P100000000000000001
1000000000000001000000000000000001
1000000000000000002C20000000000001
1000000000000000000100000000000001
1000000000000000000000000000000001
1000000000000000000000000000000001
1000000000000000000000000000000001
1000000000000000000000000000020001
10000000000000000000000000001C0001
1000000100000000000000000000020001
1000002C20000000000000000000000E01
1000000000000000000000000000000001
1111111111111111111111111111111111