1111111111111111111111111111111111
1000000000000000000000000020000001
10P00000000000000000000002C0000001
1000020000000000000000000020000001
10000C2000000000000000000000000001
1000020000002000000000000000000001
1000000000000000000000000000000001
1000000002000000000000000020000001
100000002C200000000000000000000001
1000000000000000002C20000000000001
10000002000000000002000000000C0001
1000000C00000000000000000000000E01
1000000000000000000000000000000001
1111111111111111111111111111111111